101 1
102 0
103 0
104 1
105 1
106 0
107 1
108 0
109 1
110 1
111 0
112 1
113 1
114 0
115 1
116 1
117 0
118 0
119 1
120 0
